11111111111111111111111111111111111111111111111111111111111111111111111111111111111111111111111111111111111111111111111111111111111111111111111111111111111111111111111111111
10000000000000000000000000000000000000000000000000000000000000000000000000000000000000000000000000000000000000000000000000000000000000000000000000000000000000000000000000001
10000000000000000000000000000000000000000000000000000000000000000000000000000000000000000000000000000000000000000000000000000000000000000000000000000000000000000000000000001
10000000000000000000000000000000000000000000000000000000000000000000000000000000000000000000000000000000000000000000000000000000000000000000000000000000000000000000000000001
10000000000000000000000010000001111111111111111111111111111111111111111111111111111111111111111111111111111111111111111111111111111111111111111111111111111111111111111111111
1000000000000000N000000011011111
10000000000000000000000000000001
10000010000000000000000000000001
10000000000000000000000000000001
10000000000000000000000000000001
10000000010000000001000000000001
1000000000000000001 100000000001
10000000000000000001000000000001
10000000000000000000000000000001
10000010000000000000000000000001
10000000000100000000000001000001
10000000000000000000000000000001
11111111111111111111111111111111
