NO ./assets/wood.xpm
SO ./assets/diamond.xpm
WE ./assets/brick_wall_cub.xpm
EA ./assets/granite_cub.xpm

F 220,100,0
C 225,30,0

11111111111111111111111111111111111111111111111111111111111111111111111111111111111111111111111111111111111111111111111111111111111111111111111111111111111111111111111111111111111111111111111111111111111111111111111111111111111111111111111111111111111111111111111111111111111111111111111111111111111111
10000000000000000000000000000000000000000000000000000000000000000000000000000000000000000000000000000000000000000000000000000000000000000000000000000000000000000000000000000000000000000000000000000000000000000000000000000000000000000000000000000000000000000000000000000000000000000000000000000000000001
10000000000000000000000000000000000000000000000000000000000000000000000000000000000000000000000000000000000000000000000000000000000000000000000000000000000000000000000000000000000000000000000000000000000000000000000000000000000000000000000000000000000000000000000000000000000000000000000000000000000001
10000000000000000000000000000000000000000000000000000000000000000000000000000000000000000000000000000000000000000000000000000000000000000000000000000000000000000000000000000000000000000000000000000000000000000000000000000000000000000000000000000000000000000000000000000000000000000000000000000000000001
10000000000000000000000010000001111111111111111111111111111111111111111111111111111111111111111111111111111111111111111111111111111111111111111111111111111111111111111111111111111111111111111111111111111111111111111111111111111111111111111111111111111111111111111111111111111111111111111111111111111111
10000000000000000000000011011111
10000000000000000001000000000001
10000010000000000010100000000001
100000000N0000000001000000000001
10000000000000000000000000000001
10000000010000100001000000000001
10000000000001010010100000000001
10000000000000100001000000000001
10000000000000000000000000000001
10000010000000000000000000000001
10000000000100000000000001000001
10000000000000000000000000000001
11111111111111111111111111111111