11111111111111111111111111111111
10000000000000000000000000000001
10000000000000000000000000000001
10000000000000000000000000000001
10000000000000000000000010000001
10000000000000000000000011011111
100000000000000N0000000000000001
10000010000000000000000000000001
10000000000000000000000000000001
10000000000000000000000000000001
10000000010000100001000000000001
10000000000001010010100000000001
10000000000000100001000000000001
10000000000000000000000000000001
10000010000000000000000000000001
10000000000100000000000001000001
10000000000000000000000000000001
11111111111111111111111111111110