NO ./assets/north.xpm
SO ./assets/south.xpm
WE ./assets/west.xpm
EA ./assets/east.xpm

F 220,100,0
C 225,30,0

111111111111111111111111
1000000000110000000000001
1011000001111100000000001
100100001    10000000000011111111111
111111111111110001110000000000000N1
10000000001100000111011111111111111
11110111111111011100000010001
11100111111111011101010010001       
11000000110101011100000010001
10000000000000001100000000001
10000000000000000001010000001
1100000111010101111101111000111
11110111 1110101 101111010001
    1       1 1   1    1 111
  
  
  111
  101
  111
